00000000000000000000000000000000000000000000000000
00000000000000000000000000000000000000000000000000
00000000000000000000011111111100000000000000000000
00000000000000000000001111111100000000000000000000
00000000000000000000111111111000000000000000000000
00000000000000000000000000000000000000000000000000
00000000000000000000000000000000000000000000000000
00000000000000000000000000000000000000000000000000
00000000000000000000000000000000000000000000000000
00000000000000000100000000000000011000000000000000
00000000000000001110000000000000000000000000000000
00000000000000011111000000000000000000000000000000
00000000000000111111100000000000000000000000000000
00000000000001111111110000000000000000000000000000
00000000000011111111111000000000000000000000000000
00000000000111111111111100000000000000000000000000
00000000001111111111111110000000000000000000000000
00000000011111111111111111000000000000000000000000
00000000111111111111111111100000000000000000000000
00000001111111111111111111110000000000000000000000
00000000111100111111100010000000000000000000000000
00000000000000000000000111000000000000000000000000
00000000000000000000011110000000000000000000000000
00000000000000000000000000000000000000000000000000
00000000000000000000000000000000000000000000000000
00000000000000000000000000000000000000000000000000
00000000000000000000000000000000000000000000000000
00000000000000000000000000000000000000000000000000
00000000000000000000000000000000000000000000000000
00000000000000000000000000000000000000000000000000
00000000000000000000000000000000000000000000000000
00000000000000000000000000000000000000000000000000
00000000000000000000000000000000000000000000000000
00000000001111100000000000000000000000000000000000
00000000000111111000000000000000000000000000000000
00000000000000000000000000000000000000000000000000
00000000000000000000000000000000000000000000000000
00000000000000000000000000000000000000000000000000
00000000000000000000000000000000000000000000000000
00000000000000000000000000000000000000000000000000
00000000000000000000000000000000000000000000000000
00000000000000000000000000000000000000000000000000
00000000000000000000000000000000000000000000000000
00000000000000000000000000000000000000000000000000
00000000000000000000000000000000000000000000000000
00000000000000000000000000000000000000000000000000
00000000000000000000000000000000000000000000000000
00000000000000000000000000000000000000000000000000
00000000000000000000000000000000000000000000000000
00000000000000000000000000000000000000000000000000
