11111111111111111111111111111111111111111111111111
11111111111111111111111111111111111111111111111111
11111111111111111111100000000011111111111111111111
11111111111111111111110000000011111111111111111111
11111111111111111111000000000111111111111111111111
11111111111111111111111111111111111111111111111111
11111111111111111111111111111111111111111111111111
11111111111111111111111111111111111111111111111111
11111111111111111111111111111111111111111111111111
11111111111111111011111111111111100111111111111111
11111111111111110001111111111111111111111111111111
11111111111111100000111111111111111111111111111111
11111111111111000000011111111111111111111111111111
11111111111110000000001111111111111111111111111111
11111111111100000000000111111111111111111111111111
11111111111000000000000011111111111111111111111111
11111111110000000000000001111111111111111111111111
11111111100000000000000000111111111111111111111111
11111111000000000000000000011111111111111111111111
11111110000000000000000000001111111111111111111111
11111111000011000000011101111111111111111111111111
11111111111111111111111000111111111111111111111111
11111111111111111111100001111111111111111111111111
11111111111111111111111111111111111111111111111111
11111111111111111111111111111111111111111111111111
11111111111111111111111111111111111111111111111111
11111111111111111111111111111111111111111111111111
11111111111111111111111111111111111111111111111111
11111111111111111111111111111111111111111111111111
11111111111111111111111111111111111111111111111111
11111111111111111111111111111111111111111111111111
11111111111111111111111111111111111111111111111111
11111111111111111111111111111111111111111111111111
11111111110000011111111111111111111111111111111111
11111111111000000111111111111111111111111111111111
11111111111111111111111111111111111111111111111111
11111111111111111111111111111111111111111111111111
11111111111111111111111111111111111111111111111111
11111111111111111111111111111111111111111111111111
11111111111111111111111111111111111111111111111111
11111111111111111111111111111111111111111111111111
11111111111111111111111111111111111111111111111111
11111111111111111111111111111111111111111111111111
11111111111111111111111111111111111111111111111111
11111111111111111111111111111111111111111111111111
11111111111111111111111111111111111111111111111111
11111111111111111111111111111111111111111111111111
11111111111111111111111111111111111111111111111111
11111111111111111111111111111111111111111111111111
11111111111111111111111111111111111111111111111111
